1111111111111111111111111
1P010C010C0000000001000C1
110001011101111110010N011
1C000000000N0100000001001
1111111000110100CN0001001
1000000000000101111001001
1000000N000001000000000N1
1000011110000000000111111
1CN0000000000CN00000000C1
1110000000111111110000001
10000000000000000000N0001
100N0000001N00000000100N1
1001011101010111100010011
1NC100C00000000C10N00N0E1
1111111111111111111111111