1111111111111111111111111111111111
1P000000000000000000000000000NC101
10100101N01000N01C10010000000101001
1010010010101010001001000010010101
1E00000000000000N0000000C0000000N1
1111111111111111111111111111111111