1111111111111111111111111111111
10000000C10C00P00E1001000001001
1001111111111001111001001001001
1000001000011001001001001001001
1001001001001001001001111001001
1C010010C1001001C0000000C001001
1111001111001001111001001001001
1000000C00000000000001001001001
1111111111111111001001001001001
10000000000000C0001001C01000001
1001111001001111001111111001001
1C00001001C010000000C10010010C1
1111001001111111111001001001111
1000001000000000C00001000001001
1111001001111111111001001111001
1C00001000C01001C00001C000C1001
1111111001111001111001111111001
10000000000010C000100C0000000C1
1001111111111111001001111001111
1C00000001C000000000000000000C1
1111111111111111111111111111111