1111111111111111111111111
1P010C010C0000000001000C1
1100010111011111100100011
1C00000000000100000001001
1111111000110100C00001001
1000000000000101111001001
1000000000000100000000001
1000011110000000000111111
1C00000000000C000000000C1
1110000000111111110000001
1000000000000000000000001
1000000000100000000010001
1001011101010111100010011
10C100C00000000C1000000E1
1111111111111111111111111