1111111111
1P01C000E1
1001000001
1001000001
1001000001
1001000001
1001000001
1001000001
1001000001
1111111111